NO mandatory/assets/N.xpm
EA mandatory/assets/E.xpm
SO mandatory/assets/S.xpm
WE mandatory/assets/W.xpm


F 200,100,12
C 135,206,235

1111111111111111111111111111111111111111111111
1000E00000000000110000000000000000000000000001
1011111110111110111111111111011111111111111101
1010000010000010000000000001000000000000000101
1010111010111010111110111111111110111110111101
1010101010100010100010000000000010100010000101
1010111010101110111011111111111010111110110101
1010000010100000000010000000010010000010100101
1011111110111111111010111111111010111110111101
1010000000000000000010000000000010000000000101
1010111111111111111111111111111111111111110101
1010100000000000000000000000000000000000010101
1010101111111111111111111111111111111111010101
1010101000000000000000000000000000000000010101
1010111011111111111111111111111111111111011101
1010000010000000000000000000000000000010000001
1011111010111111111111111111111111111010111101
1010000010000000000000000000000000000010000001
1010111111111111111111111111111111111111111101
1010000000000000000000000000000000000000000101
1010111111111111111111111111111111111111110101
1010100000000000000000000000000000000000010101
1010101111111111111111111111111111111111010101
1010101000000000000000000000000000000000010101
1010111011111111111111111111111111111111010101
1010000010000000000000000000000000000010000101
1011111110111111111111111111111111111111111101
1000000000000000000000000000000000000000000001
1111111111111111111111111111111111111111111111
