NO assets/N.xpm
EA assets/E.xpm
SO assets/S.xpm
WE assets/W.xpm


F 200,100,1
C 225,30,0


111111111
1000E0001
111111111