NO mandatory/assets/N.xpm
EA mandatory/assets/E.xpm
SO mandatory/assets/S.xpm
WE mandatory/assets/W.xpm


F 200,100,1
C 225,30,0


111111111
1000N0001
111111111