NO bonus/assets/DOOM_W1_116.xpm
EA bonus/assets/DOOM_W3_161.xpm
SO bonus/assets/DOOM_W4_212.xpm
WE bonus/assets/DOOM_W2_117.xpm


F 49,49,49
C 225,30,0


111111111111111111111111111111111111111111111111111111111111111111111
100000000D00000D0000000D0000D00000000D00000000D0000000D00000000000001
10111111111111111111111111111111D111111111111111111111111111111111101
101000000000000000000000000000010100000000000000000000000000000000101
101011111111111111110000000000010100000011111111110000000011111110101
101010000000000000001110000000010100000111000000111000000110000110101
10101101111111111011011111110001D100011111000111100000000110000110101
101010010000000001100000000011000000111000000000000000000011111110101
101011011111111111100000000001100011110000000000000000000010000010101
101010000000000000100111111110000100011111111110000000000010000010101
101011111111111110100100000010000100010000000010000000000010000010101
101000000000000000100100000010000100010000000010000000000010000010101
101011111111111110100111011110000100010000000011101110000010000010101
101010000000000000100000000000000100010000000000000000000010000010101
101011111111111110100000000000000100010000000000000000000010000010101
101000000000000000100000000000000100010000000000000000000010000010101
101011111111111111100111111110000100010000000011111111000010000010101
101010000000000000100000000000000100010000000000000000000010000010101
101011111111111110100000000000000100010000000000000000000010000010101
101000000000000000100000000000000100010000000000000000000010000010101
101011111111111111100111111110000100010000000011111111000010000010101
101010000000000000100000000000000100010000000000000000000010000010101
101011111111111110100000000000000100010000000000000000000010000010101
101000000000000000100000000000000100010000000000000000000010000010101
101011111111111111100111111110000100010000000011111111000010000010101
101010000000000000100000000000000100010000000000000000000010000010101
101011111111111110100000000000000100010000000000000000000010000010101
101000000000000000100000000000000100010000000000000000000010000010101
101011111111111111100111111110000100010000000011111111000010000010101
101010000000000000100000000000000100010000000000000000000010000010101
101011111111111110100000000000000100010000000000000000000010000010101
111111111111111111111111111111111111111111111111111111111111111111111
